113 30

 :::::::::::::::::::::::::::::::::::::::::::::::::::::::::::::::::::::::::::::::::::::::::::::::::::::::::::::::
 :::::::::::::::::::::::::::::::::::::::::::::::::::::::::::::::::::::::::::::::::::::::::::::::::::::::::::::::
 :::::::::::::::::::::::::::::::::::::::::::::::::::::::::::::::::::::::::::::::::::::::::::::::::::::::::::::::
 :::::::::::::::::::::::::::::::::::::::::::::::::::::::::::::::::::::::::::::::::::::::::::::::::::::::::::::::
 :::::::::::::::::::::::::::::::::::::::::::::::::::::::::::::::::::::::::::::::::::::::::::::::::::::::::::::::
 :::::::::::::::::::::::::::::::::::::::::::::::::::::::::::::::::::::::::::::::::::::::::::::::::::::::::::::::
 :::::::::::::::::::::::::::::::::::::::::::::::::::::::::::::::::::::::::::::::::::::::::::::::::::::::::::::::
 :::::::::::::::::::::::::::::::::::::::::::::::::::::::::::::::::::::::::::::::::::::::::::::::::::::::::::::::
 ::::::::::::::::::::::::::::::::::::::::::::::::::::::::::::::::::::::::::::::::::::::::::::::::::::ASLFFG:::::
 ::::::::::::::::::::::?::::::::::::::::::::UIIIIIIO::::::::::::::::::HJGA::::::::::::::::::::::::::UIIIIIIO::::
 ::::::::UIO:UIIIIO::::R::UIO:::::UIO::UIIO:TTTTTTTT:UIIO::::::::UIO:UIIIIO:::::::UIO:::::UIO::UIIO:TTTTTTTT:UII
 ::UIIO::RZR:RRRRRR:::UTO:RZRUIO::RRRO:RZZR:RRRRRRRR:RRRR::UIIO::RZR:RRRRRR:::UIO:RZRUIO::RRRO:RZZR:RRRRRRRR:RRR
   ZPPZ  TPT ZZPPZZ   ZPZ TPTZPZ  ZPZR TPPT ZZPPZZPZ TPPT  ZPPZ  TPT ZZPPZZ   ZPZ TPTZPZ  ZPZR TPPT ZZPPZZDZ TPP
 ---------------------------------------------------------------------------------------------------------------
 ---------------------------------------------------------------------------------------------------------------
 ----------b------------------------------------------------------b---------------------------------------------
 -----------b------------------------------------------------------b--------------------------------------------
d@-----------b------------------------------------------------------b-------------------------------------------
 -------------b------------------------------------------------------b------------------------------------------
 --------------b------------------------------------------------------b-----------------------------------------
 -------------------------------UIIO----------UIIO--------------------------------------UIIO----------UIIO------
 ------UIO----UIO--------UIIIO--RRRRUIIIIIO--URRRRO--UIIO------UIO----UIO--------UIIIO--RRRRUIIIIIO--URRRRO--UII
 --UIO-RRR--UIRRR--UIIIO-RRRRR--RRRRRRRRRRR--RRRRRR--RRRR--UIO-RRR--UIRRR--UIIIO-RRRRR--RRRRRRRRRRR--RRRRRR--RRR
   RRR RRR  RRRRR  RRRRR RRRRR  RRRRRRRRRRR  RRRRRR  RRRR  RRR RRR  RRRRR  RRRRR RRRRR  RRRRRRRRRRR  RRRRRR  RRR

     0  0  0    #   1      #   2      #     #       #        1      #    #   1   #    2  #     #      #        #
  0  0  0  #    #       1    #      #        #      2     #       #     2          #     1      #       # 2   #
0  0  0      #    #     #         2     #         #     #    #       #     #      #         #        #

