113 30

 :::::::::::::::::::::::::::::::::::::::::::::::::::::::::::::::::::::::::::::::::::::::::::::::::::::::::::::::
 :::::::::::::::::::::::::::::::::::::::::::::::::::::::::::::::::::::::::::::::::::::::::::::::::::::::::::::::
 :::::::::::::::::::::::::::::::::::::::::::::::::::::::::::::::::::::::::::::::::::::::::::::::::::::::::::::::
 :::::::::::::::::::::::::::::::::::::::::::::::::::::::::::::::::::::::::::::::::::::::::::::::::::::::::::::::
 :::::::::::::::::::::::::::::::::::::::::::::::::::::::::::::::::::::::::::::::::::::::::::::::::::::::::::::::
 :::::::::::::::::::::::::::::::::::::::::::::::::::::::::::::::::::::::::::::::::::::::::::::::::::::::::::::::
 :::::::::::::::::::::::::::::::::::::::::::::::::::::::::::::::::::::::::::::::::::::::::::::::::::::::::::::::
 :::::::::::::::::::::::::::::::::::::::::::::::::::::::::::::::::::::::::::::::::::::::::::::::::::::::::::::::
 ::::::::::::::::::::::::::::::::::::::::::::::::::::::::::::::::::::::::::::::::::::::::::::::::::::ASLFFG:::::
 ::::::::::::::::::::::?::::::::::::::::::::UIIIIIIO::::::::::::::::::HJGA::::::::::::::::::::::::::UIIIIIIO::::
 ::::::::UIO:UIIIIO::::R::UIO:::::UIO::UIIO:TTTTTTTT:UIIO::::::::UIO:UIIIIO:::::::UIO:::::UIO::UIIO:TTTTTTTT:UII
 ::UIIO::RZR:RRRRRR:::UTO:RZRUIO::RRRO:RZZR:RRRRRRRR:RRRR::UIIO::RZR:RRRRRR:::UIO:RZRUIO::RRRO:RZZR:RRRRRRRR:RRR
   ZPPZ  TPT ZZPPZZ   ZPZ TPTZPZ  ZPZR TPPT ZZPPZZPZ TPPT  ZPPZ  TPT ZZZÍZZ   ZPZ TPTZPZ  ZPZR TPPT ZZPPZZÉZ TPP
 -----Y--------N--------Y--N-----b--N-----N--------Y------------------Y----Y------------------Y----------N------
 -------------------------------------------------------N-----------------------N----------b--------N------N----
 -------N-----------------Y---b---b------------------N---------N------------------------------N---------N-------
 -Y------------N----------------------------N------------------------N-----------------N-----b------Y--N--------
d@--------------------------b----b------N---------------------------N--------N-----N-------b----b-------b-------
 -Y-----------N-------------------------------N-------------N-----------------------N---------------------------
 ------------------------------Y-b-----Y------------------Y--------------------------------N------b-------------
 ---------N---------Y-----------UIIO----------UIIO-----------------------N--------------UIIO--Y-------UIIO------
 ------UIO----UIO--------UIIIO--RRRRUIIIIIO--URRRRO--UIIO------UIO----UIO--------UIIIO--RRRRUIIIIIO--URRRRO--UII
 --UIO-RRR--UIRRR--UIIIO-RRRRR--RRRRRRRRRRR--RRRRRR--RRRR--UIO-RRR--UIRRR--UIIIOtRRRRRt-RRRRRRRRRRR--RRRRRR--RRR
   RRR RRR  RRRRR  RRRRR RRRRR--RRRRRRRRRRR  RRRRRR  RRRR  RRR RRR  RRRRR  RRRRR RRRRR  RRRRRRRRRRR  RRRRRR  RRR
                            -Y-
     0  0  0  0 #0  1  -----Y  2      #     #       #        1      #    #   1   #    2  #     #      #        #
  0  0k-0  #Y--Y#0-Y----1  # #      #        #      2     #       #     2          #     1      #       # 2   #
0  0  0b-----#-----#0   #         2     #         #     #    #       #     #      #         #        #

