113 30

 :::::::::::::::::::::::::::::::::::::::::::::::::::::::::::::::::::::::::::::::::::::::::::::::::::::::::::::::
 :::::::::::::::::::::::::::::::::::::::::::::::::::::::::::::::::::::::::::::::::::::::::::::::::::::::::::::::
 :::::::::::::::::::::::::::::::::::::::::::::::::::::::::::::::::::::::::::::::::::::::::::::::::::::::::::::::
 :::::::::::::::::::::::::::::::::::::::::::::::::::::::::::::::::::::::::::::::::::::::::::::::::::::::::::::::
 :::::::::::::::::::::::::::::::::::::::::::::::::::::::::::::::::::::::::::::::::::::::::::::::::::::::::::::::
 :::::::::::::::::::::::::::::::::::::::::::::::::::::::::::::::::::::::::::::::::::::::::::::::::::::::::::::::
 :::::::::::::::::::::::::::::::::::::::::::::::::::::::::::::::::::::::::::::::::::::::::::::::::::::::::::::::
 :::::::::::::::::::::::::::::::::::::::::::::::::::::::::::::::::::::::::::::::::::::::::::::::::::::::::::::::
 ::::::::::::::::::::::::::::::::::::::::::::::::::::::::::::::::::::::::::::::::::::::::::::::::::::ASLFFG:::::
 ::::::::::::::::::::::?::::::::::::::::::::UIIIIIIO::::::::::::::::::HJGA::::::::::::::::::::::::::UIIIIIIO::::
 ::::::::UIO:UIIIIO::::R::UIO:::::UIO::UIIO:TTTTTTTT:UIIO::::::::UIO:UIIIIO:::::::UIO:::::UIO::UIIO:TTTTTTTT:UII
 ::UIIO::RZR:RRRRRR:::UTO:RZRUIO::RRRO:RZZR:RRRRRRRR:RRRR::UIIO::RZR:RRRRRR:::UIO:RZRUIO::RRRO:RZZR:RRRRRRRR:RRR
   ZPPZ  TPT ZZPPZZ   ZPZ TPTZPZ  ZPZR TPPT ZZPPZZPZ TPPT  ZPPZ  TPT ZZZÍZZ   ZPZ TPTZPZ  ZPZR TPPT ZZPPZZÉZ TPP
 -----t-----------------t--------------------------t------------------t----t------------------t-----------------
 ---------------------------------------------------------------------------------------------------------------
 -------------------------t-------------------------------------------------------------------------------------
 -t-------------------------------------------------------------------------------------------------t-----------
d@--------------------------------------------------------------------------------------------------------------
 -t-------------------------------------------------------------------------------------------------------------
 ------------------------------t-------t------------------t-----------------------------------------------------
 -------------------t----------UIIO----------UIIO--------------------------------------UIIO--t-------UIIO------
 ------UIO----UIO--------UIIIO--RRRRUIIIIIO--URRRRO--UIIO------UIO----UIO--------UIIIO--RRRRUIIIIIO--URRRRO--UII
 --UIO-RRR--UIRRR--UIIIO-RRRRR--RRRRRRRRRRR--RRRRRR--RRRR--UIO-RRR--UIRRR--UIIIOtRRRRRt-RRRRRRRRRRR--RRRRRR--RRR
   RRR RRR  RRRRR  RRRRR RRRRR--RRRRRRRRRRR  RRRRRR  RRRR  RRR RRR  RRRRR  RRRRR RRRRR  RRRRRRRRRRR  RRRRRR  RRR
                            -t-
     0  0  0  0 #0  1  -----t  2      #     #       #        1      #    #   1   #    2  #     #      #        #
  0  0k-0  #t--t#0------1  # #      #        #      2     #       #     2          #     1      #       # 2   #
0  0  0------#-----#0   #         2     #         #     #    #       #     #      #         #        #

