55 35
  !oooo;;oo;%%oooo!;o_ASLFFG_oooo!;%%!oooo;!%oooo%!
  oooooooooo%%o!ooooo______!%_%%oooooo;!ooooooooooo
  o!%ooooooooooo%%%!oooo+oooo;%%%%o!;ooooooo;!%oooo
  (===============================================)
  [```````````````````````````````````````````````]
  |MM_____________________________________________|
  __9______________________________________________
  ____VzÁX_____VzÁVzÁ_____VzÁ___VzÁ________________
  ____ipő______ipőipő_____ipő___ipő__M_____________
  ____úüö______úüöúüö_____úüö___úüö________________
  _________________________________________________
  _______________M_________________________X_______
  ______m_____________________X____________________
  ____VzÁVzÁX______VzÁ_______VzÁVzÁ_________VzÁ____
  ____ipőipő_______ipőm____m_ipőipő________mipő____
  ____úüöúüö_______úüö_______úüöúüö_________úüö____
  _________________________________________________
  _______M______________X__________________________
  __________m___________m____________m_X___________
  ____VzÁ___________VzÁVzÁ__________VzÁ_______VzÁ__
  ____ipő___________ipőipő__________ipő_______ipő__
  ____úüö___________úüöúüö__________úüö_______úüö__
  _________________________________________________
  ______m______________________m___________________
  ___VzÁVzÁ_______VzÁ_______VzÁVzÁ_________________
  ___ipőipő_______ipő_______ipőipő__M______________
  ___úüöúüö_______úüö_______úüöúüö_________________
  _______________________________________M_________
  _____M___________M_______________________________
  _____________________________________nfffh_______
  __________________________________M__KÖÖÖá__M__8_
  _____________________________________ŐÚÚÚŰ_______
  ____XXX__X_____________________________________XX
  ____MMM__M______________ß______________________MM
                          é


