55 33
  !oooo;;oo;%%oooo!;o_ASLFFG_oooo!;%%!oooo;!%oooo%!
  oooooooooo%%o!ooooo______!%_%%oooooo;!ooooooooooo
  o!%ooooooooooo%%%!oooo+oooo;%%%%o!;ooooooo;!%oooo
  (===============================================)
  [```````````````````````````````````````````````]
  |_______________________________________________|
 é@________________________________________________
  ____###______#######_____###___###________ó______
  ____###______#######_____###___###_______________
  ____###______#######_____###___###_______________
  _________________________________________________
  _________________________________________________
  _________________________________________________
  ____######_______###_______######_________###____
  ____######_______###_______######_________###____
  ____######_______###_______######_________###____
  _________________________________________________
  _________________________________________________
  _________________________________________________
  ____###___________######__________###_______###__
  ____###___________######__________###_______###__
  ____###___________######__________###_______###__
  _________________________________________________
  _________________________________________________
  _________________________________________________
  _________________________________________________
  _________________________________________________
  _________________________________________________
  _________________________________________________
  _________________________________________________
  _________________________________________________
  _________________________________________________
  _________________________________________________
  _________________________________________________



