55 35
  !oooo;;oo;%%oooo!;o_ASLFFG_oooo!;%%!oooo;!%oooo%!
  oooooooooo%%o!ooooo______!%_%%oooooo;!ooooooooooo
  o!%ooooooooooo%%%!oooo+oooo;%%%%o!;ooooooo;!%oooo
  (===============================================)
  [```````````````````````````````````````````````]
  |mm_____________________________________________|
 __________________________________________________
  ____rzuX_____rzurzu_____rzu___rzu________ó_______
  ____ipő______ipőipő_____ipő___ipő__m_____________
  ____úüö______úüöúüö_____úüö___úüö________________
  _________________________________________________
  _______________m_________________________X_______
  ____________________________X____________________
  ____rzurzuX______rzu_______rzurzu_________rzu____
  ____ipőipő_______ipő_______ipőipő_________ipő____
  ____úüöúüö_______úüö_______úüöúüö_________úüö____
  _________________________________________________
  _______m______________X__________________________
  _____________________________________X___________
  ____rzu___________rzurzu__________rzu_______rzu__
  ____ipő___________ipőipő__________ipő_______ipő__
  ____úüö___________úüöúüö__________úüö_______úüö__
  _________________________________________________
  _________________________________________________
  ___rzurzu_______rzu_______rzurzu_________________
  ___ipőipő_______ipő_______ipőipő__m______________
  ___úüöúüö_______úüö_______úüöúüö_________________
  _______________________________________m_________
  _____m___________m_______________________________
  _____________________________________nfffh_______
  __________________________________m__KÖÖÖá__m____
  _____________________________________ŐÚÚÚŰ_______
  ____XXX__X______________ß______________m_______XX
  ____mmm__m______________é______________________mm



